Nom: Inconnu par le joueur (Gurrine)
Prénom : Hitam
Surnom: Hitam
Date de naissance: 20 juin 446
Age: 19 ans
Lieu de Naissance: Inconnu du joueur (village vert)
Adresse: Forêt blanche
Etudes: Formation dispensée par son maitre
Profession: manieur d'énergie

Taille: 173cm
Corpulence: maigre
Couleur de peau: pâle
Couleur de cheveux: noir
Couleur des yeux: vert
Vision: bonne
Gaucher
Etat de santé: normale, allergie au miel
Signes distinctifs: Une cicatrice sur le molet gauche

Aspect extérieur
Vetement: usagés
Accessoires: le livre dans lequel il prend des notes, un harmonica
Coiffure: négligé
Tatouage: non
Maquillage: non

Famille
Pere:Hong Gurrine
mere: Plava Gurrine
Etat du couple des parents: ensembles
Profession des parents: tiennent la bibliothèque du village vert
 Frèresn et soeur: fils unique
Place du personnage dans la fraterie: unique enfant (n'as pas de souvenir de sa vie en famille)
Relation avec les parets: aucun souvenir

Vie quotidienne:
Habitude du quotidien: jouer de l'harmonica pour se détendre et passer le temps
Moyen de déplacement: pieds
mot favorit: destin
Habitude allimentaire: mange de tout, tendance végétarienne
Plat et boisson préféré:Thé
Ce qu'il aime dans la vie de tout les jours: s'entrainer/étudier
Ce qu'il n'aime pas: Ne pas réussir à s'endormmir
Comportement en publique: volontaire

Relation: uniquement son maitre

Qualité: curiosité
Defaut: impatience
Conséquence: assez énergique mais se précipite parfois trop
Opinion politique: anarchique
Son désir profond: découvrir le monde
Succés: maitriser les 3 magies
Echecs: aucun jusqu'a présent
Espoirs: vivre heureux et rendre fier son maitre
Peurs: Le décevoir