Nom : Zeit
Prénom : Valkoinen
Surnom : Senseirb
Date de naissance: 21 décembre 404
Age : 61 ans
Lieu de Naissance : Inconnu
Adresse: Forêt blanche
Etudes: Académie de magie. 
A tenté de maitriser les 3 magies en autodidacte,
mais a du arrêter lorsqu'on l'a découvert (interdiction d'utiliser les 3 magies en même temps)

Taille : 175 cm
Corpulence : normale
Couleur de peau : Blanc
Couleur de cheveux : Blanc
Couleur des yeux : Change en fonction de son humeur (soit rouge, soit vert, soit bleu)
Vision : Très bonne
Droitier
Etat de santé : bonne malgré son âge.
Signes distinctifs: la couleur de ses yeux.

Aspect extérieur
Vêtements : tunique blanche
Accessoires : une canne
Coiffure : cheuveux longs
Tatouage : non
Maquillage : non

Famille
Père : Inconnu
Mère : Inconnue
Etat du couple des parents : Inconnu
Frères et soeurs : une soeur (connait son passé)
Place du personnage dans la fratrie : lien fort entre frère et soeur par le passé
Relation avec les parents : Inconnu

Vie quotidienne
Habitude du quotidien: lire et écrire des livres, entrainer son disciple.
Moyen de déplacement: pieds
Mot favori : magie
Habitude alimentaire: mange de tout, tendance carnivore
Plat et boisson préféré: Saké
Ce qu'il aime dans la vie quotidienne : étudier la magie, enseigner.
Ce qu'il n'aime pas : L'autorité
Comportement en public : un peu froid

Relation : uniquement par son élève et sa soeur

Qualité : Ambition
Défaut : Têtu
Conséquence : Est déterminé à faire apprendre les 3 magies à son disciple.
Opinion politique : Contre les restrictions sur la magie
Son désir profond : (faire) maitriser les 3 magies
Succès : Avoir trouvé un disciple qui puisse maitriser les 3 magies
Echecs : N'avoir pas pu maitriser les 3 magies lui même.
Espoirs : Faire évoluer son disciple afin de le rendre plus puissant
Peurs : Mourir sans avoir percé tous les secrets de la magie


 